20 15  # 宽度 高度
####################
#P        #   C    #
# #### ## # #### # #
# #  C #  #    # # #
# # ## # ## ## # # #
# #    #    C  # # #
# #### ###### ## # #
#      #   K     # #
# #### # ####### # #
# #  # #   C   # # #
# # ## # ##### # # #
# #    #   C   # # #
# ######### ## # # #
#E   C        #   E#
####################